PPPPPPPPPPPPPPPPPPPPPPPPPPPPPPPPPPPPPPPPPPPPPPPPPP??????????????????????????????????????????????????
PPPPPPPPPPPPPPPPPPPPPPPPPPPPPPPPPPPPPPPPPPPPPPPPPP??????????????????????????????????????????????????
PPPPPPPPPPPPPPPPPPPPPPPPPPPPPPPPPPPPPPPPPPPPPPPPPP??????????????????????????????????????????????????
PPPTTTBBBBBBBBBBBSSBBBBBTTTTTTTSSTTTTSSTTTTSSTTPPP??????????????????????????????????????????????????
PPPTTTBBBBBBSBBBSBSSSBBBTTTTTTSSTTTTSSTTTTTSSTTPPP??????????????????????????????????????????????????
PPPSTSBBBBSSSSSSSSSSSSSBTTTTSTTSTASAASSAAASSTSTPPP??????????????????????????????????????????????????
PPPSSSSBSSSSSSSSBSSSBSSSTSTSSSSSSSSSSSSSSASSSSSPPP??????????????????????????????????????????????????
PPPTSSSSSSBBSSSBBBSSBSSSSSSSSSSTSSASSSSSSSSTSTSPPP??????????????????????????????????????????????????
PPPTSSSSSBSSSSSSBSSBSSSSSTSTSTTSSAAAASSAASSBBBSPPP??????????????????????????????????????????????????
PPPSSTSBSSSSSBBSSBSSSBBSTTTTTTSSTAAAASSAAASSBBSPPP??????????????????????????????????????????????????
PPPSTTBBBSBBBBBBSSKBBBBBTTTTTTSSTAAAASSAAASSBBSPPP??????????????????????????????????????????????????
PPPTTTBBBBBBBBBBBSSBBBBBTTTTTSSTTAASSSAAASSBBBSPPP??????????????????????????????????????????????????
PPPTTTBBBBBBBBBBBBSSBBBBTTTTTSSTTSSSSSAASSAASSSPPP??????????????????????????????????????????????????
PPPTTTBBBBBBBBBBBSSSSSSSTSSSSTSSSSSAASSSSAAASSSPPP??????????????????????????????????????????????????
PPPTTTBBBBBBBBBBBSSBSSSSSSSSSSSTSAAAAASSSSAAABSPPP??????????????????????????????????????????????????
PPPTTTBBBBBBBBBBBBSSBBBBSTTTSSTTTTTTTTSSBSSBBBSPPP??????????????????????????????????????????????????
PPPTTTBBBBBBBBBBBBBSSBBBTTTSSTTTTTTTTSSTBSSBBBSPPP??????????????????????????????????????????????????
PPPTTTBBBBBBBBBBBBSSBBBBTTSSTTTTTTTTTTSSBBSSBBSPPP??????????????????????????????????????????????????
PPPTTTBBBBBBBBBBBBBSSBBBTSSTKTTTTTTTTTSSBSSBBBSPPP??????????????????????????????????????????????????
PPPTTTBBBBBBBBBBBBKBSSBBTTSSTTTTTTTTKSSTBBSSBBBPPP??????????????????????????????????????????????????
PPPTTTTTTTTTTTTTTTTTTSSTTSSTTTTTTTTTTSSTBBSSBBBPPP??????????????????????????????????????????????????
PPPTTTTTTTTTTTTTTTTTTSSTTTSSTTTTTTTTTTSSBSSBBBKPPP??????????????????????????????????????????????????
PPPTTTTTTTTTTTTTTTTTTKSSTTTSSTTTTTTTTSSTSSAABBBPPP??????????????????????????????????????????????????
PPPTTTTTTTTTTTTTTTTTTTSSTTSSTTTTTTTTTSSTBSSAABBPPP??????????????????????????????????????????????????
PPPTTTTTTTTTTTTTTTTTTTTSSSSTTTTTTTTTTSSTBBSSBBBPPP??????????????????????????????????????????????????
PPPTTTTKTTTTTTTTTTTTTTSSSSTTTTTTTTTTTSSTBSSBBBBPPP??????????????????????????????????????????????????
PPPTTTTTTTTTTTTTTTTTKSSTTSSTTTTTTTTTSSTTSSAATTTPPP??????????????????????????????????????????????????
PPPTTTTTTTTTTTTTTTTTTSSTTSSTTTTTTTTTTSSSSTTAATTPPP??????????????????????????????????????????????????
PPPAAAAAAAAAAAAATTTTTSSTKTSSTTTTTTTBBBSSBBBAABBPPP??????????????????????????????????????????????????
PPPAAAAAAAAAAAAATTTTTTSSTSSTTTTTTTTBBSSSSBAABBBPPP??????????????????????????????????????????????????
PPPAAAAAAAAAAAAATTTTTTTTSSTTTTTTTTTBBBSSBBAABBBPPP??????????????????????????????????????????????????
PPPAAAAAAAAAAAAATTTTTTTSSSSTTTTTTTTBBBSSBBAABBBPPP??????????????????????????????????????????????????
PPPAAAAAAAAAAAAATTTTTTTTSSTTTTTTTTTBBBBSSAABBBBPPP??????????????????????????????????????????????????
PPPAAAAAAAAAAAAATTTTTTTTTSSTTTTTTTTBBBSSBAABBBBPPP??????????????????????????????????????????????????
PPPAAAAAAAAAAAAATTTTTTTTTSSTTTTTTTTBBBSSBAABBBBPPP??????????????????????????????????????????????????
PPPAAAAAAAAAAAAATTTTTTTTSSTTTTTTTTTBBSSBAABBSSBPPP??????????????????????????????????????????????????
PPPAAAAAAAAAAAAATTTTTTTTTSSTTTTTTTTBBSSAASSSSSSPPP??????????????????????????????????????????????????
PPPAAAAAASAAAAAATTTTTTTTSSSTSTTTTTTBSSBSSSSSBBSPPP??????????????????????????????????????????????????
PPPAASAASSSSAAAATTTTTTTSSSSSSSTTSTTSSBSSSAABBBBPPP??????????????????????????????????????????????????
PPPSSSSSSASSSAAATTSSSSTTSSASASSSSSSSBSSBBAAABBBPPP??????????????????????????????????????????????????
PPPSSASSAAAASSAASSSSSSSSSAABABSSBSSSSSSSAABAABBPPP??????????????????????????????????????????????????
PPPAAAAAAAAAASSSSSABBKSSBABBBBBBBBBBSBBSSBBBAAAPPP??????????????????????????????????????????????????
PPPTKTTTTATAATSSTTABBBBSSBBBBBBBBBBBSSSSTTTTTAAPPP??????????????????????????????????????????????????
PPPTTTTAAAAAATTTTTTBBBBSSBBBBBBBBBBBBSSAATTTTTTPPP??????????????????????????????????????????????????
PPPTATAAATATTTTTTTTBBBBBSSBBBBBBBBBBBSSAABBBBBBPPP??????????????????????????????????????????????????
PPPAAAATTTTTTTTTTTTBBBBBBSSBBBBBBBBBSSSSBBBBBBBPPP??????????????????????????????????????????????????
PPPATATTTTTTTTTTTTTBBBBBSSSSKBBBBBBSSBBSSBBBBBBPPP??????????????????????????????????????????????????
PPPPPPPPPPPPPPPPPPPPPPPPPPPPPPPPPPPPPPPPPPPPPPPPPP??????????????????????????????????????????????????
PPPPPPPPPPPPPPPPPPPPPPPPPPPPPPPPPPPPPPPPPPPPPPPPPP??????????????????????????????????????????????????
PPPPPPPPPPPPPPPPPPPPPPPPPPPPPPPPPPPPPPPPPPPPPPPPPP??????????????????????????????????????????????????
????????????????????????????????????????????????????????????????????????????????????????????????????
????????????????????????????????????????????????????????????????????????????????????????????????????
????????????????????????????????????????????????????????????????????????????????????????????????????
????????????????????????????????????????????????????????????????????????????????????????????????????
????????????????????????????????????????????????????????????????????????????????????????????????????
????????????????????????????????????????????????????????????????????????????????????????????????????
????????????????????????????????????????????????????????????????????????????????????????????????????
????????????????????????????????????????????????????????????????????????????????????????????????????
????????????????????????????????????????????????????????????????????????????????????????????????????
????????????????????????????????????????????????????????????????????????????????????????????????????
????????????????????????????????????????????????????????????????????????????????????????????????????
????????????????????????????????????????????????????????????????????????????????????????????????????
????????????????????????????????????????????????????????????????????????????????????????????????????
????????????????????????????????????????????????????????????????????????????????????????????????????
????????????????????????????????????????????????????????????????????????????????????????????????????
????????????????????????????????????????????????????????????????????????????????????????????????????
????????????????????????????????????????????????????????????????????????????????????????????????????
????????????????????????????????????????????????????????????????????????????????????????????????????
????????????????????????????????????????????????????????????????????????????????????????????????????
????????????????????????????????????????????????????????????????????????????????????????????????????
????????????????????????????????????????????????????????????????????????????????????????????????????
????????????????????????????????????????????????????????????????????????????????????????????????????
????????????????????????????????????????????????????????????????????????????????????????????????????
????????????????????????????????????????????????????????????????????????????????????????????????????
????????????????????????????????????????????????????????????????????????????????????????????????????
????????????????????????????????????????????????????????????????????????????????????????????????????
????????????????????????????????????????????????????????????????????????????????????????????????????
????????????????????????????????????????????????????????????????????????????????????????????????????
????????????????????????????????????????????????????????????????????????????????????????????????????
????????????????????????????????????????????????????????????????????????????????????????????????????
????????????????????????????????????????????????????????????????????????????????????????????????????
????????????????????????????????????????????????????????????????????????????????????????????????????
????????????????????????????????????????????????????????????????????????????????????????????????????
????????????????????????????????????????????????????????????????????????????????????????????????????
????????????????????????????????????????????????????????????????????????????????????????????????????
????????????????????????????????????????????????????????????????????????????????????????????????????
????????????????????????????????????????????????????????????????????????????????????????????????????
????????????????????????????????????????????????????????????????????????????????????????????????????
????????????????????????????????????????????????????????????????????????????????????????????????????
????????????????????????????????????????????????????????????????????????????????????????????????????
????????????????????????????????????????????????????????????????????????????????????????????????????
????????????????????????????????????????????????????????????????????????????????????????????????????
????????????????????????????????????????????????????????????????????????????????????????????????????
????????????????????????????????????????????????????????????????????????????????????????????????????
????????????????????????????????????????????????????????????????????????????????????????????????????
????????????????????????????????????????????????????????????????????????????????????????????????????
????????????????????????????????????????????????????????????????????????????????????????????????????
????????????????????????????????????????????????????????????????????????????????????????????????????
????????????????????????????????????????????????????????????????????????????????????????????????????
????????????????????????????????????????????????????????????????????????????????????????????????????
